tileset	./gfx/tileset.png
stage_title	Stage Blah
trigged_messages	5
Press right close to the corner to turn clockwise.
Press left once the ball is falling.
Press left when it's falling again.
And right when you're close to the corner.
Don let the ball fall, or you'll break it.
map	32	32
0 0 0 0 0 0 0 0 0 0 0 0 0 0 0 0 0 0 0 0 0 0 0 0 0 0 0 0 0 0 0 0 
0 2 2 2 2 2 2 2 2 2 2 2 2 2 2 2 2 2 2 2 2 2 2 2 2 2 2 2 2 2 2 0 
0 2 1 1 1 1 1 1 1 1 1 1 1 1 1 1 1 1 1 1 1 1 1 1 1 1 1 1 1 1 2 0 
0 2 1 1 1 1 1 1 1 1 1 1 1 1 1 1 1 1 1 1 1 1 1 1 1 1 1 1 1 1 2 0 
0 2 1 1 1 1 1 1 1 1 1 1 1 1 1 1 1 1 1 1 1 1 1 1 1 1 1 1 1 1 2 0 
0 2 1 1 1 1 1 1 1 1 1 1 1 1 1 1 1 1 1 1 1 1 1 1 1 1 1 1 1 1 2 0 
0 2 1 1 1 1 1 1 1 1 1 1 1 1 1 1 1 1 1 1 1 1 1 1 1 1 1 1 1 1 2 0 
0 2 1 1 1 1 1 1 1 1 1 1 1 1 1 1 1 1 1 1 1 1 1 1 1 1 1 1 1 1 2 0 
0 2 1 1 1 1 1 1 1 1 1 1 1 1 1 1 1 1 1 1 1 1 1 1 1 1 1 1 1 1 2 0 
0 2 1 1 1 1 1 1 1 1 1 1 1 1 1 1 1 1 1 1 1 1 1 1 1 1 1 1 1 1 2 0 
0 2 1 1 1 1 1 1 1 1 1 1 1 1 1 1 1 1 1 1 1 1 1 1 1 1 1 1 1 1 2 0 
0 2 1 1 1 1 1 1 1 1 1 1 1 1 1 1 1 1 1 1 1 1 1 1 1 1 1 1 1 1 2 0 
0 2 1 1 1 1 1 1 1 1 1 1 1 1 1 1 1 1 1 1 1 1 1 1 1 1 1 1 1 1 2 0 
0 2 1 1 1 1 1 1 1 1 1 1 1 1 1 1 1 1 1 1 1 1 1 1 1 1 1 1 1 1 2 0 
0 2 1 1 1 1 1 1 1 1 1 1 1 1 1 1 1 1 1 1 1 1 1 1 1 1 1 1 1 1 2 0 
0 2 1 1 1 1 1 1 1 1 1 1 1 1 1 1 1 1 1 1 1 1 1 1 1 1 1 1 1 1 2 0 
0 2 1 1 1 1 1 1 1 1 1 1 1 1 1 1 1 1 1 1 1 1 1 1 1 1 1 1 1 1 2 0 
0 2 1 1 1 1 1 1 1 1 1 1 1 1 1 1 1 1 1 1 1 1 1 1 1 1 1 1 1 1 2 0 
0 2 1 1 1 1 1 1 1 1 1 2 2 2 2 2 2 2 2 2 2 1 1 1 1 1 1 1 1 1 2 0 
0 2 1 1 1 1 1 1 1 1 1 2 0 0 0 0 0 0 0 0 2 1 1 1 1 1 1 1 1 1 2 0 
0 2 1 1 1 1 1 1 1 1 1 2 0 0 0 0 0 0 0 0 2 1 1 1 1 1 1 1 1 1 2 0 
0 2 1 1 1 1 1 1 1 1 1 2 0 0 0 0 0 0 0 0 2 1 1 1 1 1 1 1 1 1 2 0 
0 2 1 1 1 1 1 1 1 1 1 2 0 0 0 0 0 0 0 0 2 1 1 1 1 1 1 1 1 1 2 0 
0 2 1 1 1 1 1 1 1 1 1 2 0 0 0 0 0 0 0 0 2 1 1 1 1 1 1 1 1 1 2 0 
0 2 1 1 1 1 1 1 1 1 1 2 0 0 0 0 0 0 0 0 2 1 1 1 1 1 1 1 1 1 2 0 
0 2 1 1 1 1 1 1 1 1 1 2 0 0 0 0 0 0 0 0 2 1 1 1 1 1 1 1 1 1 2 0 
0 2 1 1 1 1 1 1 1 1 1 2 0 0 0 0 0 0 0 0 2 1 1 1 1 1 1 1 1 1 2 0 
0 2 1 1 1 1 1 1 1 1 1 2 0 0 0 0 0 0 0 0 2 1 1 1 1 1 1 1 1 1 2 0 
0 2 1 1 1 1 1 1 1 1 1 2 0 0 0 0 0 0 0 0 2 1 1 1 1 1 1 1 1 1 2 0 
0 2 1 1 1 1 1 1 1 1 1 2 0 0 0 0 0 0 0 0 2 1 1 1 1 1 1 1 1 3 2 0 
0 2 2 2 2 2 2 2 2 2 2 2 0 0 0 0 0 0 0 0 2 2 2 2 2 2 2 2 2 2 2 0 
0 0 0 0 0 0 0 0 0 0 0 0 0 0 0 0 0 0 0 0 0 0 0 0 0 0 0 0 0 0 0 0
marker	33
geometry	32	32
0 0 0 0 0 0 0 0 0 0 0 0 0 0 0 0 0 0 0 0 0 0 0 0 0 0 0 0 0 0 0 0 
0 34 34 34 34 34 34 34 34 34 34 34 34 34 34 34 34 34 34 34 34 34 34 34 34 34 34 34 34 34 34 0 
0 34 0 0 0 0 0 0 0 0 0 0 0 0 0 0 0 0 0 0 0 0 0 0 0 0 0 0 0 0 34 0 
0 34 0 0 0 0 0 0 0 0 0 0 0 0 0 0 0 0 0 0 0 0 0 0 0 0 0 0 0 0 34 0 
0 34 0 0 0 0 0 0 0 0 0 0 0 0 0 0 0 0 0 0 0 0 0 0 0 0 0 0 0 0 34 0 
0 34 0 0 0 0 0 0 0 0 0 0 0 0 0 0 0 0 0 0 0 0 0 0 0 0 0 0 0 0 34 0 
0 34 0 0 0 0 0 0 0 0 0 0 0 0 0 0 0 0 0 0 0 0 0 0 0 0 0 0 0 0 34 0 
0 34 0 0 0 0 0 0 0 0 0 0 0 0 0 0 0 0 0 0 0 0 0 0 0 0 0 0 0 0 34 0 
0 34 0 0 0 0 0 0 0 0 0 0 0 0 0 0 0 0 0 0 0 0 0 0 0 0 0 0 0 0 34 0 
0 34 0 0 0 0 0 0 0 0 0 0 0 0 0 0 0 0 0 0 0 0 0 0 0 0 0 0 0 0 34 0 
0 34 0 0 0 0 0 0 0 0 0 0 0 0 0 0 0 0 0 0 0 0 0 0 0 0 0 0 0 0 34 0 
0 34 0 0 0 0 0 0 0 0 0 0 0 0 0 0 0 0 0 0 0 0 0 0 0 0 0 0 0 0 34 0 
0 34 0 0 0 0 0 0 0 0 0 0 0 0 0 0 0 0 0 0 0 0 0 0 0 0 0 0 0 0 34 0 
0 34 0 0 0 0 0 0 0 0 0 0 0 0 0 0 0 0 0 0 0 0 0 0 0 0 0 0 0 0 34 0 
0 34 0 0 0 0 0 0 0 0 0 0 0 0 0 0 0 0 0 0 0 0 0 0 0 0 0 0 0 0 34 0 
0 34 0 0 0 0 0 41 41 41 41 41 41 41 41 41 0 0 0 0 0 0 0 41 0 0 0 0 0 0 34 0 
0 34 0 0 0 0 0 0 0 0 0 0 0 0 0 0 0 0 0 0 0 0 0 41 0 0 0 0 0 0 34 0 
0 34 0 0 0 0 0 0 0 0 0 0 0 39 0 0 0 0 0 0 0 0 0 41 0 0 0 0 0 0 34 0 
0 34 0 0 0 0 0 0 0 0 0 34 34 34 34 34 34 34 34 34 34 0 0 41 0 0 0 0 0 0 34 0 
0 34 0 0 0 0 0 0 0 0 0 34 0 0 0 0 0 0 0 0 34 0 0 41 0 0 0 0 0 0 34 0 
0 34 0 0 0 0 0 0 0 0 0 34 0 0 0 0 0 0 0 0 34 0 0 41 0 0 0 0 0 0 34 0 
0 34 0 0 0 0 0 0 0 0 0 34 0 0 0 0 0 0 0 0 34 0 0 0 0 0 0 0 0 0 34 0 
0 34 0 0 0 0 0 0 0 0 0 34 0 0 0 0 0 0 0 0 34 40 0 0 0 0 0 0 0 0 34 0 
0 34 0 0 0 0 0 0 0 0 0 34 0 0 0 0 0 0 0 0 34 0 0 0 0 0 0 0 0 0 34 0 
0 34 0 0 0 0 0 0 0 0 0 34 0 0 0 0 0 0 0 0 34 0 0 0 0 0 0 0 0 0 34 0 
0 34 0 0 0 0 0 0 0 0 38 34 0 0 0 0 0 0 0 0 34 0 0 41 41 41 41 41 0 0 34 0 
0 34 0 0 0 0 0 0 0 0 0 34 0 0 0 0 0 0 0 0 34 0 0 0 0 0 0 0 0 0 34 0 
0 34 0 0 0 0 0 0 0 0 0 34 0 0 0 0 0 0 0 0 34 0 0 0 0 0 0 0 0 0 34 0 
0 34 0 0 0 0 0 0 0 0 0 34 0 0 0 0 0 0 0 0 34 0 0 0 0 0 0 0 0 0 34 0 
0 34 33 0 0 37 0 0 0 1 0 34 0 0 0 0 0 0 0 0 34 0 0 0 0 0 0 0 0 35 34 0 
0 34 34 34 34 34 34 34 34 34 34 34 0 0 0 0 0 0 0 0 34 34 34 34 34 34 34 34 34 34 34 0 
0 0 0 0 0 0 0 0 0 0 0 0 0 0 0 0 0 0 0 0 0 0 0 0 0 0 0 0 0 0 0 0
