tileset	./gfx/tileset.png
stage_title	Stage Blah
trigged_messages	2
Now show me what you've just learned.
That's it, keep going like this!
map	32	32
0 0 0 0 0 0 0 0 0 0 0 0 0 0 0 0 0 0 0 0 0 0 0 0 0 0 0 0 0 0 0 0 
0 49 50 50 50 50 50 50 50 50 50 50 50 50 50 50 50 50 50 50 50 50 50 50 50 73 74 75 50 50 51 0 
0 57 11 12 13 14 11 12 13 14 11 12 13 14 11 12 13 14 11 12 13 14 11 12 13 14 11 12 13 14 57 0 
0 57 19 20 21 22 19 20 21 22 19 20 21 22 19 20 21 22 19 20 21 22 19 20 21 22 19 20 21 22 57 0 
0 57 27 28 29 30 27 28 29 30 27 28 29 30 27 28 29 30 27 28 29 30 27 28 29 30 27 28 29 30 57 0 
0 57 11 12 13 14 11 12 13 14 11 12 13 14 11 12 13 14 11 12 13 14 11 12 13 14 11 12 13 14 57 0 
0 57 19 20 21 22 19 20 21 22 19 20 21 22 19 20 21 22 19 20 21 22 19 20 21 22 19 20 21 22 57 0 
0 57 27 28 29 30 27 28 29 30 27 28 29 30 27 28 29 30 27 28 29 30 27 28 29 30 27 28 29 30 57 0 
0 57 11 12 13 14 11 12 13 14 11 12 13 14 11 12 13 14 11 12 13 14 11 12 13 14 11 12 13 14 57 0 
0 57 19 20 21 22 19 20 21 22 19 20 21 22 19 20 21 22 19 20 21 22 19 20 21 22 19 20 21 22 57 0 
49 67 27 28 29 30 27 28 29 30 27 28 29 30 27 28 29 30 27 28 29 30 27 28 29 30 27 28 29 30 65 51 
57 94 11 12 13 14 11 12 13 14 11 12 13 14 11 12 13 14 11 12 13 14 11 12 13 14 11 12 13 14 96 57 
57 94 19 20 21 22 19 20 21 22 19 20 21 22 19 20 21 22 19 20 21 22 19 20 21 22 19 20 21 22 96 57 
57 94 27 28 29 30 27 28 29 30 27 28 29 30 27 28 29 30 27 28 29 30 27 28 29 30 27 28 29 30 96 57 
57 94 11 12 13 14 11 12 13 14 11 12 13 14 11 12 13 14 11 12 13 14 11 12 13 14 11 12 13 14 96 57 
57 94 19 20 21 22 19 20 21 22 19 20 21 22 19 20 21 22 19 20 21 22 19 20 21 22 19 20 21 22 96 57 
57 94 27 28 29 30 27 28 29 30 27 28 29 30 27 28 29 30 27 28 29 30 27 28 29 30 27 28 29 30 96 57 
57 94 11 12 13 14 11 12 13 14 11 12 13 14 11 12 13 14 11 12 13 14 11 12 13 14 11 12 13 14 96 57 
57 94 19 20 21 22 19 20 21 22 19 49 66 66 66 66 66 66 66 66 51 22 19 20 21 22 19 20 21 22 96 57 
57 94 27 28 29 30 27 28 29 30 27 59 0 0 0 0 0 0 0 0 59 30 27 28 29 30 27 28 29 30 96 57 
65 57 11 12 13 14 11 12 13 14 11 59 0 0 0 0 0 0 0 0 59 14 11 12 13 14 11 12 13 14 49 67 
0 57 19 20 21 22 19 20 21 22 19 59 0 0 0 0 0 0 0 0 59 22 19 20 21 22 19 20 21 22 57 0 
0 57 27 28 29 30 27 28 29 30 27 59 0 0 0 0 0 0 0 0 59 30 27 28 29 30 27 28 29 30 57 0 
0 57 11 12 13 14 11 12 13 14 11 65 51 0 0 0 0 0 0 49 67 14 11 12 13 14 11 12 13 14 57 0 
0 57 19 20 21 22 19 20 21 22 19 96 57 0 0 0 0 0 0 57 94 22 19 20 21 22 19 20 21 22 57 0 
0 57 27 28 29 30 27 28 29 30 27 49 67 0 0 0 0 0 0 65 51 30 27 28 29 30 27 28 29 30 57 0 
0 57 11 12 13 14 11 12 13 14 11 59 0 0 0 0 0 0 0 0 57 14 11 12 13 14 11 12 13 14 57 0 
0 57 19 20 21 22 19 20 21 22 19 59 0 0 0 0 0 0 0 0 57 22 19 20 21 22 19 20 21 22 57 0 
0 57 27 28 29 30 27 28 29 30 27 59 0 0 0 0 0 0 0 0 57 30 27 28 29 30 27 28 29 30 57 0 
0 57 11 12 13 14 11 12 13 14 11 59 0 0 0 0 0 0 0 0 57 14 11 12 13 14 11 12 13 89 57 0 
0 65 66 66 66 66 66 66 66 66 66 67 0 0 0 0 0 0 0 0 65 66 66 66 66 66 66 66 66 66 67 0 
0 0 0 0 0 0 0 0 0 0 0 0 0 0 0 0 0 0 0 0 0 0 0 0 0 0 0 0 0 0 0 0
marker	32
geometry	32	32
0 0 0 0 0 0 0 0 0 0 0 0 0 0 0 0 0 0 0 0 0 0 0 0 0 0 0 0 0 0 0 0 
0 34 34 34 34 34 34 34 34 34 34 34 34 34 34 34 34 34 34 34 34 34 34 34 34 34 34 34 34 34 34 0 
0 34 0 0 0 0 0 0 0 0 0 0 0 0 0 0 0 0 0 0 0 0 0 0 0 0 0 0 0 0 34 0 
0 34 0 0 0 0 0 0 0 0 0 0 0 0 0 0 0 0 0 0 0 0 0 0 0 0 0 0 0 0 34 0 
0 34 0 0 0 0 0 0 0 0 0 0 0 0 0 0 0 0 0 0 0 0 0 0 0 0 0 0 0 0 34 0 
0 34 0 0 0 0 0 0 0 0 0 0 0 0 0 0 0 0 0 0 0 0 0 0 0 0 0 0 0 0 34 0 
0 34 0 0 0 0 0 0 0 0 0 0 0 0 0 0 0 0 0 0 0 0 0 0 0 0 0 0 0 0 34 0 
0 34 0 0 0 0 0 0 0 0 0 0 0 0 0 0 0 0 0 0 0 0 0 0 0 0 0 0 0 0 34 0 
0 34 0 0 0 0 0 0 0 0 0 0 0 0 0 0 0 0 0 0 0 0 0 0 0 0 0 0 0 0 34 0 
0 34 0 0 0 0 0 0 0 0 0 0 0 0 0 0 0 0 0 0 0 0 0 0 0 0 0 0 0 0 34 0 
34 34 0 0 0 0 0 0 0 0 0 0 0 0 0 0 0 0 0 0 0 0 0 0 0 0 0 0 0 0 34 34 
34 36 0 0 0 0 0 0 0 0 0 0 0 0 0 0 0 0 0 0 0 0 0 0 0 0 0 0 0 0 36 34 
34 36 0 0 0 0 0 0 0 0 0 0 0 0 0 0 0 0 0 0 0 0 0 0 0 0 0 0 0 0 36 34 
34 36 0 0 0 0 0 0 0 0 0 0 0 0 0 0 0 0 0 0 0 0 0 0 0 0 0 0 0 0 36 34 
34 36 0 0 0 0 0 0 0 0 0 0 0 0 0 0 0 0 0 0 0 0 0 0 0 0 0 0 0 0 36 34 
34 36 0 0 0 0 0 0 0 0 0 0 0 0 0 0 0 0 0 0 0 0 0 0 0 0 0 0 0 0 36 34 
34 36 0 0 0 0 0 0 0 0 0 0 0 0 0 0 0 0 0 0 0 0 0 0 0 0 0 0 0 0 36 34 
34 36 0 0 0 0 0 0 0 0 0 0 0 0 0 0 0 0 0 0 0 0 0 0 0 0 0 0 0 0 36 34 
34 36 0 0 0 0 0 0 0 0 0 34 34 34 34 34 34 34 34 34 34 0 0 0 0 0 0 0 0 0 36 34 
34 36 0 0 0 0 0 0 0 0 0 34 0 0 0 0 0 0 0 0 34 0 0 0 0 0 0 0 0 0 36 34 
34 34 0 0 0 0 0 0 0 0 0 34 0 0 0 0 0 0 0 0 34 0 0 0 0 0 0 0 0 0 34 34 
0 34 0 0 0 0 0 0 0 0 0 34 0 0 0 0 0 0 0 0 34 0 0 0 0 0 0 0 0 0 34 0 
0 34 0 0 0 0 0 0 0 0 0 34 0 0 0 0 0 0 0 0 34 0 0 0 0 0 0 0 0 0 34 0 
0 34 0 0 0 0 0 0 0 0 0 34 0 0 0 0 0 0 0 0 34 0 0 0 0 0 0 0 0 0 34 0 
0 34 0 0 0 0 0 0 0 0 0 36 0 0 0 0 0 0 0 0 36 0 0 0 0 0 0 0 0 0 34 0 
0 34 0 0 0 0 0 0 0 0 0 34 0 0 0 0 0 0 0 0 34 0 0 0 0 0 0 0 0 0 34 0 
0 34 0 0 0 0 0 0 0 0 0 34 0 0 0 0 0 0 0 0 34 0 0 0 0 0 0 0 0 0 34 0 
0 34 0 0 0 0 0 0 0 0 0 34 0 0 0 0 0 0 0 0 34 0 0 0 0 0 0 0 0 0 34 0 
0 34 0 0 0 0 0 0 0 0 0 34 0 0 0 0 0 0 0 0 34 0 0 0 0 0 0 0 0 0 34 0 
0 34 33 0 0 37 0 0 0 0 0 34 0 0 0 0 0 0 0 0 34 0 0 38 0 0 0 0 0 35 34 0 
0 34 34 34 34 34 34 34 34 34 34 34 0 0 0 0 0 0 0 0 34 34 34 34 34 34 34 34 34 34 34 0 
0 0 0 0 0 0 0 0 0 0 0 0 0 0 0 0 0 0 0 0 0 0 0 0 0 0 0 0 0 0 0 0
