tileset	./gfx/tileset.png
stage_title	Stage Blah
trigged_messages	1
Good luck!
map	32	32
0 0 0 0 0 0 0 0 0 0 0 0 0 0 0 0 0 0 0 0 0 0 0 0 0 0 0 0 0 0 0 0 
0 0 0 0 0 0 0 0 0 0 0 0 0 0 0 0 0 0 0 0 0 0 0 0 0 0 0 0 0 0 0 0 
0 0 0 0 0 0 0 0 0 0 0 0 0 0 0 0 0 0 0 0 0 0 0 0 0 0 0 0 0 0 0 0 
0 0 0 0 0 0 0 0 0 0 0 0 0 0 49 50 51 0 0 0 0 0 0 0 0 0 0 0 0 0 0 0 
0 0 0 0 49 50 55 55 50 50 50 50 50 50 67 95 65 50 50 50 50 50 50 50 50 50 50 51 0 0 0 0 
0 0 0 0 57 11 84 88 94 11 12 13 14 11 12 13 14 11 12 13 14 11 12 13 14 11 12 59 0 0 0 0 
0 0 0 0 57 19 20 21 52 56 20 21 22 19 20 21 22 19 20 21 22 19 20 21 22 19 20 59 0 0 0 0 
0 0 0 0 57 27 28 29 52 53 66 66 66 66 66 66 66 66 66 66 66 66 51 29 30 27 28 59 0 0 0 0 
0 0 0 0 59 11 12 13 68 64 12 13 14 11 12 13 14 11 12 13 14 97 59 13 14 11 12 59 0 0 0 0 
0 0 0 0 59 19 20 21 60 88 20 21 22 19 20 21 22 19 20 21 22 19 59 21 22 19 20 59 0 0 0 0 
0 0 0 0 59 27 28 29 88 27 28 29 30 27 28 29 30 27 28 29 30 27 59 29 30 27 28 59 0 0 0 0 
0 0 0 49 67 11 12 13 14 11 12 50 50 50 50 50 50 50 50 50 50 50 67 13 14 11 12 59 0 0 0 0 
0 0 0 57 94 19 20 21 22 19 20 21 22 19 20 21 22 19 20 21 22 19 20 21 22 19 20 59 0 0 0 0 
0 0 0 57 94 27 28 29 30 27 28 29 30 27 28 29 30 27 28 29 30 27 28 29 30 27 28 65 51 0 0 0 
0 0 0 57 94 11 12 13 14 11 12 13 14 11 12 13 14 11 12 13 14 11 12 13 14 11 12 96 59 0 0 0 
0 0 0 57 94 19 20 21 22 19 20 21 22 19 20 21 22 19 20 21 22 19 20 21 22 19 20 49 67 0 0 0 
0 0 0 57 94 27 28 29 30 27 28 29 30 27 28 29 30 27 28 29 30 27 28 29 30 27 28 59 0 0 0 0 
0 0 0 57 94 11 12 13 14 11 12 13 14 11 12 13 14 11 12 13 14 11 12 13 14 11 12 59 0 0 0 0 
0 0 0 57 94 19 20 21 22 19 20 21 22 19 20 21 22 19 20 21 22 19 20 21 22 19 20 59 0 0 0 0 
0 0 0 57 94 27 28 29 30 27 28 29 30 27 28 29 30 27 28 29 30 27 28 29 30 27 28 59 0 0 0 0 
0 0 0 57 94 11 12 13 14 11 12 13 14 11 12 13 14 11 12 13 14 11 12 13 14 11 12 59 0 0 0 0 
0 0 0 57 94 19 20 21 22 19 20 21 22 19 20 21 22 19 20 21 22 19 20 21 22 19 20 65 51 0 0 0 
0 0 0 57 94 27 28 29 30 27 28 29 30 27 28 29 30 27 28 29 30 27 28 29 30 27 28 96 59 0 0 0 
0 0 0 65 51 11 12 13 14 11 12 13 14 11 12 13 14 11 12 13 14 11 12 13 14 11 12 49 67 0 0 0 
0 0 0 0 59 19 20 21 22 19 20 21 22 19 20 21 22 19 20 21 22 19 20 21 22 19 20 59 0 0 0 0 
0 0 0 0 59 27 28 29 30 27 28 29 30 27 28 29 30 27 28 29 30 27 28 29 30 27 28 59 0 0 0 0 
0 0 0 0 59 11 12 11 14 11 28 13 14 11 12 13 14 11 12 13 14 11 12 13 14 11 12 59 0 0 0 0 
0 0 0 0 65 66 66 66 66 66 66 66 66 66 66 66 66 66 66 66 66 66 66 66 73 74 75 67 0 0 0 0 
0 0 0 0 0 0 0 0 0 0 0 0 0 0 0 0 0 0 0 0 0 0 0 0 0 0 0 0 0 0 0 0 
0 0 0 0 0 0 0 0 0 0 0 0 0 0 0 0 0 0 0 0 0 0 0 0 0 0 0 0 0 0 0 0 
0 0 0 0 0 0 0 0 0 0 0 0 0 0 0 0 0 0 0 0 0 0 0 0 0 0 0 0 0 0 0 0 
0 0 0 0 0 0 0 0 0 0 0 0 0 0 0 0 0 0 0 0 0 0 0 0 0 0 0 0 0 0 0 0
marker	32
geometry	32	32
0 0 0 0 0 0 0 0 0 0 0 0 0 0 0 0 0 0 0 0 0 0 0 0 0 0 0 0 0 0 0 0 
0 0 0 0 0 0 0 0 0 0 0 0 0 0 0 0 0 0 0 0 0 0 0 0 0 0 0 0 0 0 0 0 
0 0 0 0 0 0 0 0 0 0 0 0 0 0 0 0 0 0 0 0 0 0 0 0 0 0 0 0 0 0 0 0 
0 0 0 0 0 0 0 0 0 0 0 0 0 0 34 34 34 34 0 0 0 0 0 0 0 0 0 0 0 0 0 0 
0 0 0 0 34 34 34 34 34 34 34 34 34 34 34 36 34 34 34 34 34 34 34 34 34 34 34 34 0 0 0 0 
0 0 0 0 34 11 34 34 94 11 12 13 14 11 12 13 14 11 12 13 14 11 12 13 14 11 12 34 0 0 0 0 
0 0 0 0 34 19 20 21 34 34 20 21 22 19 20 21 22 19 20 21 22 19 20 21 22 19 20 34 0 0 0 0 
0 0 0 0 34 27 28 29 34 34 34 34 34 34 34 34 34 34 34 34 34 34 34 29 30 27 28 34 0 0 0 0 
0 0 0 0 34 11 12 13 34 34 12 13 14 11 12 13 14 11 12 13 14 35 34 13 14 11 12 34 0 0 0 0 
0 0 0 0 34 19 20 21 34 34 20 21 22 19 20 21 22 19 20 21 22 19 34 21 22 19 20 34 0 0 0 0 
0 0 0 0 34 27 28 29 34 27 28 29 30 27 28 29 30 27 28 29 30 27 34 29 30 27 28 34 0 0 0 0 
0 0 0 34 34 11 12 13 14 11 12 34 34 34 34 34 34 34 34 34 34 34 34 13 14 11 12 34 0 0 0 0 
0 0 0 34 36 19 20 21 22 19 20 21 22 19 20 21 22 19 20 21 22 19 20 21 22 19 20 34 34 0 0 0 
0 0 0 34 36 27 28 29 30 27 28 29 30 27 28 29 30 27 28 29 30 27 28 29 30 27 28 34 34 0 0 0 
0 0 0 34 36 11 12 13 14 11 12 13 14 11 12 13 14 11 12 13 14 11 12 13 14 11 12 36 34 0 0 0 
0 0 0 34 36 19 20 21 22 19 20 21 22 19 20 21 22 19 20 21 22 19 20 21 22 19 20 34 34 0 0 0 
0 0 0 34 36 11 28 29 30 27 28 29 30 27 28 29 30 27 28 29 30 27 28 29 30 27 28 34 0 0 0 0 
0 0 0 34 36 11 12 13 14 11 12 13 14 11 12 13 14 11 12 13 14 11 12 13 14 11 12 34 0 0 0 0 
0 0 0 34 36 19 20 21 22 19 20 21 22 19 20 21 22 19 20 21 22 19 20 21 22 19 20 34 0 0 0 0 
0 0 0 34 36 27 28 29 30 27 28 29 30 27 28 29 30 27 28 29 30 27 28 29 30 27 28 34 0 0 0 0 
0 0 0 34 36 11 12 13 14 11 12 13 14 11 12 13 14 11 12 13 14 11 12 13 14 11 12 34 0 0 0 0 
0 0 0 34 36 19 20 21 22 19 20 21 22 19 20 21 22 19 20 21 22 19 20 21 22 19 20 34 34 0 0 0 
0 0 0 34 36 27 28 29 30 27 28 29 30 27 28 29 30 27 28 29 30 27 28 29 30 27 28 36 34 0 0 0 
0 0 0 34 34 11 12 13 14 11 12 13 14 11 12 13 14 11 12 13 14 11 12 13 14 11 12 34 34 0 0 0 
0 0 0 0 34 19 20 21 22 19 20 21 22 19 20 21 22 19 20 21 22 19 20 21 22 19 20 34 0 0 0 0 
0 0 0 0 34 27 28 29 30 27 28 29 30 27 28 29 30 27 28 29 30 27 28 29 30 27 28 34 0 0 0 0 
0 0 0 0 34 11 12 33 14 11 12 37 14 11 12 13 14 11 12 13 14 11 12 13 14 11 12 34 0 0 0 0 
0 0 0 0 34 34 34 34 34 34 34 34 34 34 34 34 34 34 34 34 34 34 34 34 34 34 34 34 0 0 0 0 
0 0 0 0 0 0 0 0 0 0 0 0 0 0 0 0 0 0 0 0 0 0 0 0 0 0 0 0 0 0 0 0 
0 0 0 0 0 0 0 0 0 0 0 0 0 0 0 0 0 0 0 0 0 0 0 0 0 0 0 0 0 0 0 0 
0 0 0 0 0 0 0 0 0 0 0 0 0 0 0 0 0 0 0 0 0 0 0 0 0 0 0 0 0 0 0 0 
0 0 0 0 0 0 0 0 0 0 0 0 0 0 0 0 0 0 0 0 0 0 0 0 0 0 0 0 0 0 0 0

