tileset	./gfx/tileset.png
stage_title	Stage Blah
trigged_messages	5
This is the last one, keep pushing!
That was tricky!
OK, you got this, don't give up!
Watch out your timing.
You're almost there, this is final stretch!!
map	32	32
0 0 0 0 0 0 0 0 0 0 0 0 0 0 0 0 0 0 0 0 0 0 0 0 0 0 0 0 0 0 0 0 
0 0 0 0 0 0 0 0 0 0 0 0 0 0 0 0 0 0 0 0 0 0 0 0 0 0 0 0 0 0 0 0 
0 0 0 0 0 0 0 0 0 0 0 0 0 0 0 0 0 0 0 0 0 0 0 0 0 0 0 0 0 0 0 0 
0 0 0 0 0 0 0 0 0 0 0 0 0 0 0 0 0 0 0 0 0 0 0 0 0 0 0 0 0 0 0 0 
0 0 0 0 0 0 0 0 0 0 0 0 0 0 0 0 0 0 0 0 0 0 0 0 0 0 0 0 0 0 0 0 
0 0 0 0 0 0 0 0 0 0 0 0 0 0 0 0 0 0 0 0 0 0 0 0 0 0 0 0 0 0 0 0 
0 0 0 0 0 0 0 0 0 0 0 0 0 0 0 0 0 0 0 0 0 0 0 0 0 0 0 0 0 0 0 0 
0 0 0 0 0 0 0 0 0 0 0 0 0 0 0 0 0 0 0 0 0 0 0 0 0 0 0 0 0 0 0 0 
0 0 0 0 0 49 50 50 50 50 50 50 50 50 50 50 50 50 50 50 50 50 50 50 50 50 51 0 0 0 0 0 
0 0 0 0 0 57 11 12 13 14 11 12 13 14 11 12 13 14 11 12 13 14 11 12 13 14 57 0 0 0 0 0 
0 0 0 0 49 67 19 20 21 22 19 20 21 22 19 20 21 22 19 20 21 22 19 20 21 22 59 51 0 0 0 0 
0 0 0 0 57 94 27 28 49 50 50 50 54 54 54 54 54 54 54 54 56 30 27 28 29 30 96 59 0 0 0 0 
0 0 0 0 57 94 11 12 65 95 95 95 65 87 87 87 87 87 87 87 88 14 11 12 13 14 68 72 0 0 0 0 
0 0 0 0 57 94 19 20 21 22 19 20 21 22 19 20 21 22 19 20 21 22 19 20 21 22 96 59 0 0 0 0 
0 0 0 0 65 51 27 28 29 30 27 28 29 30 27 28 29 30 27 28 29 30 27 28 29 30 57 88 0 0 0 0 
0 0 0 0 0 68 54 54 50 54 54 54 56 14 11 12 13 14 11 12 13 14 11 12 13 14 57 0 0 0 0 0 
0 0 0 0 0 68 86 88 95 84 81 82 83 50 54 54 50 54 54 56 21 22 19 20 52 54 72 0 0 0 0 0 
0 0 0 0 0 57 97 28 29 30 27 28 29 30 84 88 95 84 86 88 29 30 27 28 84 86 72 0 0 0 0 0 
0 0 0 0 49 67 11 12 13 14 11 12 13 14 11 12 13 14 11 12 13 14 11 12 13 14 57 0 0 0 0 0 
0 0 0 0 57 94 19 20 21 22 19 20 21 22 19 20 21 22 19 20 21 22 19 20 21 22 57 0 0 0 0 0 
0 0 0 0 57 94 27 28 29 30 27 28 29 30 27 28 29 30 27 28 29 30 27 28 29 30 57 0 0 0 0 0 
0 0 0 0 57 94 11 12 13 14 11 12 13 14 11 12 13 14 11 12 13 14 11 12 13 14 57 0 0 0 0 0 
0 0 0 0 65 51 19 20 21 22 19 20 52 54 54 54 54 54 54 20 21 22 19 20 21 22 57 0 0 0 0 0 
0 0 0 0 0 65 66 66 66 66 66 66 86 86 86 86 86 86 86 66 66 51 93 49 66 66 67 0 0 0 0 0 
0 0 0 0 0 0 0 0 0 0 0 0 0 0 0 0 0 0 0 0 0 65 50 67 0 0 0 0 0 0 0 0 
0 0 0 0 0 0 0 0 0 0 0 0 0 0 0 0 0 0 0 0 0 0 0 0 0 0 0 0 0 0 0 0 
0 0 0 0 0 0 0 0 0 0 0 0 0 0 0 0 0 0 0 0 0 0 0 0 0 0 0 0 0 0 0 0 
0 0 0 0 0 0 0 0 0 0 0 0 0 0 0 0 0 0 0 0 0 0 0 0 0 0 0 0 0 0 0 0 
0 0 0 0 0 0 0 0 0 0 0 0 0 0 0 0 0 0 0 0 0 0 0 0 0 0 0 0 0 0 0 0 
0 0 0 0 0 0 0 0 0 0 0 0 0 0 0 0 0 0 0 0 0 0 0 0 0 0 0 0 0 0 0 0 
0 0 0 0 0 0 0 0 0 0 0 0 0 0 0 0 0 0 0 0 0 0 0 0 0 0 0 0 0 0 0 0 
0 0 0 0 0 0 0 0 0 0 0 0 0 0 0 0 0 0 0 0 0 0 0 0 0 0 0 0 0 0 0 0
marker	32
geometry	32	32
0 0 0 0 0 0 0 0 0 0 0 0 0 0 0 0 0 0 0 0 0 0 0 0 0 0 0 0 0 0 0 0 
0 0 0 0 0 0 0 0 0 0 0 0 0 0 0 0 0 0 0 0 0 0 0 0 0 0 0 0 0 0 0 0 
0 0 0 0 0 0 0 0 0 0 0 0 0 0 0 0 0 0 0 0 0 0 0 0 0 0 0 0 0 0 0 0 
0 0 0 0 0 0 0 0 0 0 0 0 0 0 0 0 0 0 0 0 0 0 0 0 0 0 0 0 0 0 0 0 
0 0 0 0 0 0 0 0 0 0 0 0 0 0 0 0 0 0 0 0 0 0 0 0 0 0 0 0 0 0 0 0 
0 0 0 0 0 0 0 0 0 0 0 0 0 0 0 0 0 0 0 0 0 0 0 0 0 0 0 0 0 0 0 0 
0 0 0 0 0 0 0 0 0 0 0 0 0 0 0 0 0 0 0 0 0 0 0 0 0 0 0 0 0 0 0 0 
0 0 0 0 0 0 0 0 0 0 0 0 0 0 0 0 0 0 0 0 0 0 0 0 0 0 0 0 0 0 0 0 
0 0 0 0 0 34 34 34 34 34 34 34 34 34 34 34 34 34 34 34 34 34 34 34 34 34 34 0 0 0 0 0 
0 0 0 0 0 34 0 0 0 0 0 0 0 0 0 0 0 0 0 0 0 0 0 0 38 0 34 0 0 0 0 0 
0 0 0 34 34 34 0 0 0 0 0 0 0 0 0 0 0 0 0 0 0 0 0 0 0 0 34 34 0 0 0 0 
0 0 0 34 34 36 0 0 34 34 34 34 34 34 34 34 34 34 34 34 34 0 0 0 0 0 36 34 0 0 0 0 
0 0 0 0 34 36 0 0 34 36 36 36 34 34 34 34 34 34 34 34 34 0 0 0 0 0 34 34 0 0 0 0 
0 0 0 0 34 36 0 0 0 0 0 0 0 0 0 0 0 0 0 0 0 0 0 0 0 0 36 34 0 0 0 0 
0 0 0 0 34 34 0 0 39 0 0 0 0 0 0 0 0 0 0 0 0 0 0 0 0 0 34 34 0 0 0 0 
0 0 0 0 0 34 34 34 34 34 34 34 34 40 0 0 0 0 0 0 0 0 0 0 0 0 34 0 0 0 0 0 
0 0 0 0 0 34 34 34 36 34 34 34 34 34 34 34 34 34 34 34 0 0 0 0 34 34 34 0 0 0 0 0 
0 0 0 0 0 34 35 0 0 0 0 0 0 41 34 34 36 34 34 34 0 0 0 0 34 34 34 0 0 0 0 0 
0 0 0 0 34 34 0 0 0 0 0 0 0 0 0 0 0 0 0 0 0 0 0 0 0 0 34 0 0 0 0 0 
0 0 0 0 34 36 0 0 0 0 0 0 0 0 0 0 0 0 0 0 0 0 0 0 0 0 34 34 0 0 0 0 
0 0 0 0 34 36 0 0 0 0 0 0 0 0 0 0 0 0 0 0 0 0 0 0 0 0 34 34 0 0 0 0 
0 0 0 0 34 36 0 0 0 0 0 0 0 0 0 0 0 0 0 0 0 0 0 0 0 0 34 0 0 0 0 0 
0 0 0 0 34 34 0 33 0 0 37 0 34 34 34 34 34 34 34 0 0 0 0 0 0 0 34 0 0 0 0 0 
0 0 0 0 0 34 34 34 34 34 34 34 34 34 34 34 34 34 34 34 34 34 36 34 34 34 34 0 0 0 0 0 
0 0 0 0 0 0 0 0 0 0 0 0 0 0 0 0 0 0 0 34 0 34 34 34 0 0 0 0 0 0 0 0 
0 0 0 0 0 0 0 0 0 0 0 0 0 0 0 0 0 0 0 0 0 0 0 0 0 0 0 0 0 0 0 0 
0 0 0 0 0 0 0 0 0 0 0 0 0 0 0 0 0 0 0 0 0 0 0 0 0 0 0 0 0 0 0 0 
0 0 0 0 0 0 0 0 0 0 0 0 0 0 0 0 0 0 0 0 0 0 0 0 0 0 0 0 0 0 0 0 
0 0 0 0 0 0 0 0 0 0 0 0 0 0 0 0 0 0 0 0 0 0 0 0 0 0 0 0 0 0 0 0 
0 0 0 0 0 0 0 0 0 0 0 0 0 0 0 0 0 0 0 0 0 0 0 0 0 0 0 0 0 0 0 0 
0 0 0 0 0 0 0 0 0 0 0 0 0 0 0 0 0 0 0 0 0 0 0 0 0 0 0 0 0 0 0 0 
0 0 0 0 0 0 0 0 0 0 0 0 0 0 0 0 0 0 0 0 0 0 0 0 0 0 0 0 0 0 0 0
